111111111111111111111111
1___2____3_3__3________1
1_2_2_2______3_________1
1_2___2_3__3__3________1
1_222223__3___3__B22___1
1____33____3__3___K2___1
1_________________22___1
1_______3__3______K2___1
1__3__3___3______B22___1
13__3___3_3____________1
1__3__3_3_3_4___3____4_1
1_3_3__3__3_4___3____4_1
13____3__3__4___444444_1
1___33_33___4__________1
1___________4__________1
111111111111111111111111