111111111111111111111111
1______________________1
1______________________1
1______________________1
1____123456____________1
1______________________1
1______________________1
1______________________1
1______________________1
1______________________1
1______________________1
1______________________1
1______________________1
1______________________1
1______________________1
111111111111111111111111